11111111111111111111111
100000000000000000000E1
1111111000000C0010C1111
111100000111111111100P1
11100000000000000000011
11111111111111111111111
