111111111111111111111
1111000000000000000E1
1P000000000000P000001
100000000000000000001
111111111111111111111
