1111111111111111111111111111111111
1E1000000000000C00000C001010000001
1010011110100000101001001110010101
1P11110010101010001001000000010101
100000000C00C0000000000000000P01C1
1111111111111111111111111111111111
