111111
1000E1
101C11
101111
1000P1
111111
