1111
10E1
1PC1
1111

1111
10E1
1PC1
1111
