111111111111
110E0000000011
11000000P00001
111C111111111
1111111111111
