1111111111
1000000001
1P11C111E0
1111111111
