1111111111
1100000001
1P11000001
100000E1C1
1111111111

