1111111111
0000000001
1P11C111E1
1111111111
