
11111111111
1P0C00E0001
11111111111
