1111111111
1000000111
1P11C111E1
1111111111
