111111111111
1000000000l1
100P000C0001
1100000000E1
111111111111
