1111111111
100PEC001
1111111111