1111111111111111111
1000000010000000001
100000C10E000000001
1000001111111110001
10000P0000000010001
1111111111111111111
