11111
111E1
1E101
1C0P1
11111
