111111111111
100000000001
1P111111P111
1E111000C111
100000000111
111111111111
