111111111111
1PoCoCoCoEo1
111111111111
