1111111111
1111E11111
1C11C11P11
1111111111
