1111111111
1000000001
1P11C111E1
1111110111
