11111111
11000001

1ECP1111
11111111
