1111111111
1110000001
1P11C111E1
1111111111
