1111111
10000P1
11C1111
10000E1
1111111