 1111111
 1000E01
 10C0001
 1P00001
 1111111
